"","Date","Doses_Given","Doses_Received","Long_Term_Care_Doses","Long_Term_Care_Given","All_Doses_Received","All_Doses_Given","New_Doses_Today","Pct_Doses_Total"
"1","12/30/20",25679,97025,24700,84,121725,25763,NA,21.2%
"2","12/31/20",28841,124325,24700,178,149025,29019,3256,19.5%
"3","1/1/21",31574,124325,24700,580,149025,32154,3135,21.6%
"4","1/2/21",32537,124325,24700,1017,149025,33554,1400,22.5%
"5","1/3/21",33835,124325,24700,1017,149025,34852,1298,23.4%
"6","1/4/21",34962,124325,24700,1324,149025,36286,1434,24.3%
"7","1/5/21",37884,134425,24700,1324,159125,39208,2922,24.6%
"8","1/6/21",50679,152075,24700,1533,176775,52212,13004,29.5%
"9","1/7/21",58914,169625,24700,2374,194325,61288,9076,31.5%
"10","1/8/21",65991,190100,24700,2474,214800,68465,7177,31.9%
"11","1/9/21",74663,202400,24700,2931,227100,77594,9129,34.2%
"12","1/10/21",77854,203375,24700,3423,228075,81277,3683,35.6%
"13","1/11/21",80796,203375,24700,3774,228075,84570,3293,37.1%
"14","1/12/21",89449,227500,24700,3884,252200,93333,8763,37.0%
"15","1/13/21",102657,251600,24700,4169,276300,106826,13493,38.7%
"16","1/14/21",112238,275000,49400,4534,324400,116772,9946,36.0%
"17","1/15/21",119065,275000,49400,5091,324400,124156,7384,38.3%
"18","1/16/21",125789,275000,49400,5601,324400,131390,7234,40.5%
"19","1/17/21",131022,275000,49400,6285,324400,137307,5917,42.3%
"20","1/18/21",133962,275000,49400,6597,324400,140559,3252,43.3%
"21","1/19/21",147609,310275,49400,6626,359675,154235,13676,42.9%
"22","1/20/21",164699,312225,49400,6816,361625,171515,17280,47.4%
"23","1/21/21",179127,330750,49400,6978,380150,186105,14590,49.0%
"24","1/22/21",193831,332250,49400,6982,381650,200813,14708,52.6%
"25","1/23/21",205089,337350,49400,6983,386750,212072,11259,54.8%
"26","1/24/21",211968,337350,49400,6983,386750,218951,6879,56.6%
"27","1/25/21",214617,337350,49400,6985,386750,221602,2651,57.3%
"28","1/26/21",227074,410175,49400,7046,459575,234120,12518,50.9%
"29","1/27/21",241466,422875,49400,9630,472275,251096,16976,53.2%
"30","1/28/21",255274,470200,49400,12408,519600,267682,16586,51.5%
"31","1/29/21",270332,470400,49400,14596,519800,284928,17246,54.8%
"32","1/30/21",284022,470600,49400,15916,520000,299938,15010,57.7%
"33","1/31/21",290886,470600,49400,16672,520000,307558,7620,59.1%
"34","2/1/21",293570,470600,49400,16943,520000,310513,2955,59.7%
"35","2/2/21",301291,486500,49400,17117,535900,318408,7895,59.4%
"36","2/3/21",316484,519225,49400,17539,568625,334023,15615,58.7%
"37","2/4/21",329521,536825,49400,18285,586225,347806,13783,59.3%
"38","2/5/21",351485,555850,49400,18777,605250,370262,22456,61.2%
"39","2/6/21",369898,559750,49400,19026,609150,388924,18662,63.8%
"40","2/7/21",377678,561150,49400,19441,610550,397119,8195,65.0%
"41","2/8/21",379624,561150,49400,19937,610550,399561,2442,65.4%
"42","2/9/21",392212,601875,49400,20904,651275,413116,13555,63.4%
"43","2/10/21",404695,602075,49400,21178,651475,425873,12757,65.4%
"44","2/11/21",420570,621075,49400,21564,670475,442134,16261,65.9%
"45","2/12/21",430228,657200,61000,21980,718200,452208,10074,63.0%
"46","2/13/21",445040,658000,61000,22197,719000,467237,15029,65.0%
"47","2/14/21",451914,658000,61000,22689,719000,474603,7366,66.0%
"48","2/15/21",455089,658000,61000,22959,719000,478048,3445,66.5%
"49","2/16/21",458431,658000,61000,23080,719000,481511,3463,67.0%
"50","2/17/21",462141,676525,61000,27498,737525,489639,8128,66.4%
"51","2/18/21",466216,691525,61000,27560,752525,493776,4137,65.6%
"52","2/19/21",469440,691525,61000,28718,752525,498158,4382,66.2%
"53","2/20/21",476828,691525,61000,28777,752525,505605,7447,67.2%
"54","2/21/21",483224,691525,61000,31959,752525,515183,9578,68.5%
"55","2/22/21",487212,691525,61000,32028,752525,519240,4057,69.0%
"56","2/23/21",500914,794230,61000,33565,855230,534479,15239,62.5%
"57","2/24/21",517445,816730,70360,35559,887090,553004,18525,62.3%
"58","2/25/21",540038,835590,70360,38481,905950,578519,25515,63.9%
"59","2/26/21",560854,870590,79460,41805,950050,602659,24140,63.4%
"60","2/27/21",586071,902020,87560,42951,989580,629022,26363,63.6%
"61","2/28/21",585785,902020,87560,41948,989580,627733,-1289,63.4%
"62","3/1/21",593908,902020,87560,42692,989580,636600,8867,64.3%
"63","3/2/21",609055,975910,91070,43647,1066980,652702,16102,61.2%
"64","3/3/21",622719,977710,91070,46060,1068780,668779,16077,62.6%
"65","3/4/21",636290,999240,119170,50907,1118410,687197,18418,61.4%
"66","3/5/21",653245,1064920,135550,53454,1200470,706699,19502,58.9%
"67","3/6/21",671389,1088150,135550,55258,1223700,726647,19948,59.4%
"68","3/7/21",677424,1088150,135550,56557,1223700,733981,7334,60.0%
"69","3/8/21",684280,1088150,135550,57924,1223700,742204,8223,60.7%
"70","3/9/21",697452,1158630,135550,59599,1294180,757051,14847,58.5%
"71","3/10/21",709581,1162330,135550,62295,1297880,771876,14825,59.5%
"72","3/11/21",724976,1209300,152150,64818,1361450,789794,17918,58.0%
"73","3/12/21",743791,1217310,165020,72606,1382330,816397,26603,59.1%
"74","3/13/21",759646,1244220,165020,76826,1409240,836472,20075,59.4%
"75","3/14/21",765768,1244220,165020,79015,1409240,844783,8311,59.9%
"76","3/15/21",768923,1244220,165020,80060,1409240,848983,4200,60.2%
"77","3/16/21",781348,1325200,174380,82532,1499580,863880,14897,57.6%
"78","3/17/21",795387,1329170,174380,84963,1503550,880350,16470,58.6%
"79","3/18/21",815030,1360780,194080,87951,1554860,902981,22631,58.1%
"80","3/19/21",831035,1398920,209690,93491,1608610,924526,21545,57.5%
"81","3/20/21",850488,1458550,209690,97509,1668240,947997,23471,56.8%
"82","3/21/21",857179,1458550,209690,98897,1668240,956076,8079,57.3%
"83","3/22/21",859907,1458550,209690,99884,1668240,959791,3715,57.5%
"84","3/23/21",874294,1527220,229580,104490,1756800,978784,18993,55.7%
"85","3/24/21",893325,1529320,230580,108094,1759900,1001419,22635,56.9%
"86","3/25/21",918490,1567660,246480,111887,1814140,1030377,28958,56.8%
"87","3/26/21",939908,1599810,268430,116479,1868240,1056387,26010,56.5%
"88","3/27/21",961713,1654450,268430,120494,1922880,1082207,25820,56.3%
"89","3/28/21",967914,1654450,268430,122948,1922880,1090862,8655,56.7%
"90","3/29/21",971620,1654450,268430,124514,1922880,1096134,5272,57.0%
"91","3/30/21",990108,1736160,268430,128167,2004590,1118275,22141,55.8%
"92","3/31/21",1010188,1755140,280130,132704,2035270,1142892,24617,56.2%
"93","4/1/21",1037549,1422550,310610,138048,1733160,1175597,32705,67.8%
"94","4/2/21",1061409,1432150,324650,143579,1756800,1204988,29391,68.6%
"95","4/3/21",1086242,1493760,325350,148089,1819110,1234331,29343,67.9%
"96","4/4/21",1091816,1493760,325350,151026,1819110,1242842,8511,68.3%
"97","4/5/21",1099355,1498430,325450,152246,1823880,1251601,8759,68.6%
"98","4/6/21",1120004,1542210,339690,156671,1881900,1276675,25074,67.8%
"99","4/7/21",1143188,1585010,340590,160845,1925600,1304033,27358,67.7%
"100","4/8/21",1163264,1585810,350290,166129,1936100,1329393,25360,68.7%
"101","4/9/21",1189295,1652590,368810,173076,2021400,1362371,32978,67.4%
"102","4/10/21",1211785,1658990,377010,178131,2036000,1389916,27545,68.3%
"103","4/11/21",1216254,1659790,379010,182300,2038800,1398554,8638,68.6%
"104","4/12/21",1219654,1659790,379010,184222,2038800,1403876,5322,68.9%
"105","4/13/21",1238723,1659790,379010,188373,2038800,1427096,23220,70.0%
"106","4/14/21",1260160,1730740,406730,192662,2137470,1452822,25726,68.0%
"107","4/15/21",1281423,1730840,410730,197029,2141570,1478452,25630,69.0%
"108","4/16/21",1299673,1730840,424800,201845,2155640,1501518,23066,69.7%
"109","4/17/21",1320705,1796680,447200,205653,2243880,1526358,24840,68.0%
"110","4/18/21",1324442,1808480,453650,207833,2262130,1532275,5917,67.7%
"111","4/19/21",1328980,1808480,453650,209782,2262130,1538762,6487,68.0%
"112","4/20/21",1345536,1829780,461840,212809,2291620,1558345,19583,68.0%
"113","4/21/21",1362754,1881500,471480,216297,2352980,1579051,20706,67.1%
"114","4/22/21",1380125,1912440,474380,219574,2386820,1599699,20648,67.0%
"115","4/23/21",1394337,1953520,482950,223819,2436470,1618156,18457,66.4%
"116","4/24/21",1406663,1964820,503190,227815,2468010,1634478,16322,66.2%
"117","4/25/21",1413744,1964820,503190,229905,2468010,1643649,9171,66.6%
"118","4/26/21",1415378,1964820,503190,231373,2468010,1646751,3102,66.7%
"119","4/27/21",1427501,1984570,510210,234420,2494780,1661921,15170,66.6%
"120","4/28/21",1442320,1984770,521610,237825,2506380,1680145,18224,67.0%
"121","4/29/21",1453607,1984770,523010,241312,2507780,1694919,14774,67.6%
"122","4/30/21",1466118,1984770,530820,244867,2515590,1710985,16066,68.0%
"123","5/1/21",1463233,1963820,538600,248069,2523370,1730521,19536,68.6%
"124","5/2/21",1486618,1984770,539600,249541,2524370,1736159,5638,68.8%
"125","5/3/21",1490066,1984770,539600,250572,2524370,1740638,4479,69.0%
"126","5/4/21",1498253,1984770,540300,253367,2525070,1751620,10982,69.4%
"127","5/5/21",1508735,1984770,549800,257311,2534570,1766046,14426,69.7%
"128","5/6/21",1516854,1984770,553300,260702,2538070,1777556,11510,70.0%
"129","5/7/21",1526245,1984770,560590,264199,2545360,1790444,12888,70.3%
"130","5/8/21",1536883,1984770,571620,267312,2556390,1804195,13751,70.6%
"131","5/9/21",1539503,1984770,571620,269881,2556390,1809384,5189,70.8%
"132","5/10/21",1542267,1984770,571620,271628,2556390,1813895,4511,71.0%
"133","5/11/21",1548432,1994470,580640,274509,2575110,1822941,9046,70.8%
"134","5/12/21",1554833,1994470,584530,277243,2579000,1832076,9135,71.0%
"135","5/13/21",1562592,1994470,589170,279578,2583640,1842170,10094,71.3%
"136","5/14/21",1575148,1994470,596820,282361,2591290,1857509,15339,71.7%
"137","5/15/21",1583318,1994670,602570,285797,2597240,1869115,11606,72.0%
"138","5/16/21",1584727,1994670,602570,287835,2597240,1872562,3447,72.1%
"139","5/17/21",1584727,1994670,602570,287835,2597240,1875646,3084,72.2%
"140","5/18/21",1590434,1994670,602570,292516,2597240,1882950,7304,72.5%
"141","5/19/21",1596721,1994670,602570,296017,2597240,1892738,9788,72.9%
"142","5/20/21",1604364,1994770,609370,299811,2604140,1904175,11437,73.1%
"143","5/21/21",1612352,1994770,617590,304344,2612360,1916696,12521,73.4%
"144","5/22/21",1618269,1994770,617590,307137,2612360,1925406,8710,73.7%
"145","5/23/21",1620470,1994770,617590,309181,2612360,1929651,4245,73.9%
"146","5/24/21",1621361,1994770,617590,310661,2612360,1932022,2371,74.0%
"147","5/25/21",1628367,1995370,622380,313033,2617750,1941400,9378,74.2%
"148","5/26/21",1634693,1995370,622760,315308,2618130,1950001,8601,74.5%
"149","5/27/21",1640111,1995370,626540,317750,2621910,1957861,7860,74.7%
"150","5/28/21",1647522,1995370,626640,320249,2622010,1967771,9910,75.0%
"151","5/29/21",1652594,1995370,626640,322926,2622010,1975520,7749,75.3%
"152","5/30/21",1653364,1995370,626640,324588,2622010,1977952,2432,75.4%
"153","5/31/21",1653663,1995370,626640,325802,2622010,1979465,1513,75.5%
"154","6/1/21",1653979,1995370,626640,327011,2622010,1980990,1525,75.6%
"155","6/2/21",1658348,1995370,648350,328459,2643720,1986807,5817,75.2%
"156","6/3/21",1662807,1995770,651450,330346,2647220,1993153,6346,75.3%
"157","6/4/21",1667342,1996070,655390,333462,2651460,2000804,7651,75.5%
"158","6/5/21",1671790,1996070,655390,336315,2651460,2008105,7301,75.7%
"159","6/6/21",1672767,1996070,655390,338593,2651460,2011360,3255,75.9%
"160","6/7/21",1673598,1996070,655390,340246,2651460,2013844,2484,76.0%
"161","6/8/21",1673598,1996070,655390,340246,2651460,2019977,6133,76.2%
"162","6/9/21",1681575,1996170,667130,345370,2663300,2026945,6968,76.1%
"163","6/10/21",1685271,1996170,667130,348055,2663300,2033326,6381,76.3%
"164","6/11/21",1689569,1996170,667130,350410,2663300,2039979,6653,76.6%
"165","6/12/21",1694668,1996170,667130,352849,2663300,2047517,7538,76.9%
"166","6/13/21",1695577,1996170,667130,353931,2663300,2049508,1991,77.0%
"167","6/14/21",1695856,1996170,667130,355404,2663300,2051260,1752,77.0%
"168","6/15/21",1699928,1995970,678050,357834,2674020,2057762,6502,77.0%
"169","6/16/21",1703619,1996070,678050,360071,2674120,2063690,5928,77.2%
"170","6/17/21",1706813,1997270,678190,362265,2675460,2069078,5388,77.3%
"171","6/18/21",1710253,1997270,681830,365186,2679100,2075439,6361,77.5%
"172","6/19/21",1714081,1997270,681830,366877,2679100,2080958,5519,77.7%
"173","6/20/21",1715755,1997270,681830,369525,2679100,2085280,4322,77.8%
"174","6/21/21",1716065,1997270,681830,370765,2679100,2086830,1550,77.9%
"175","6/22/21",1718407,1997270,690370,372413,2687640,2090820,3990,77.8%
"176","6/23/21",1721353,1997270,690790,374220,2688060,2095573,4753,78.0%
"177","6/24/21",1724334,1997270,691070,376428,2688340,2100762,5189,78.1%
"178","6/25/21",1726361,1997270,691070,379541,2688340,2105902,5140,78.3%
"179","6/28/21",1731660,1997270,709580,388068,2706850,2119728,13826,78.3%
"180","6/29/21",1734230,1997270,709580,389742,2706850,2123972,4244,78.5%
"181","6/30/21",1742442,1997270,709580,391886,2706850,2134328,10356,78.8%
"182","7/1/21",1746767,1997270,709580,393874,2706850,2140641,6313,79.1%
"183","7/2/21",1749951,1997270,709580,395958,2706850,2145909,5268,79.1%
"184","7/5/21",1753518,1997270,726770,401453,2724040,2154971,14330,79.1%
